111111111111
10CN0100C101
1NC0C0NC0101
1C000C010001
1P0N10N01EN1
111111111111
