1111111111111
100CC1C1C0EC1
110101CC0CC01
1C00C00C10001
1P1C00C0111E1
1111111111111
