11111111111111111111111111111
10010C00000C000111001C1C11C11
1011000C0000C001000C101010001
1C10000C010C0000C00000C0C0101
100C00100000010000C010C01EC01
100000C000C10010C000100111C11
1C01100C0010010010C100C001001
1C00C0010000C000C01C000000101
101010C0C00C00C000C0C000C0001
100C00110010C0010100110C1C001
10010C0C00C0C010CCC00C00001E1
10C0101CC0101C100111000C00011
11010C00000C000111001C1C11C11
1000000C0000C001000C101010001
1P10000C010C0000C00000C0C0101
11010C0C00C0C010CCC01E00001E1
11111111111111111111111111111
