11111111111111
1100NC00010N01
10N0100N0CC0C1
1C01C000100C01
1C0010CC0N0001
1010CN000001E1
100100101000C1
1PC0000C0N0CN1
100010N0000001
11C0N0C10N0C01
11111111111111
