11111111111111111111111111111111
1000000C001000C00C10C110000C0E01
10NC0C000N0C0C0N00C00CN00NCN0001
1C000101000001000N001101C000C001
10N00C000100C000N000010000NC0001
100C0100C00N0C1000N00C000000C101
10N00C00N0N010000N0C0C0N00CC0101
10C001000100000001000C0000C0C001
10100C00100001000N0N000N0C0N0001
1P000C0N000C00C0C0011N000C010011
11111111111111111111111111111111
